WWWWWWWWW
WWFFFWWWW
WFCWDFFWW
WFFFFDDWW
WWWWWFPWW
WWWWWFFWW
WWFCFCFWW
WWFFFFFWW
WWWWWWWWW
