WWWWWWWWW
WWWFFFWWW
WWWFFFWWW
WWWFFFWWW
WWWFFFWWW
WWWFFFWWW
WFFFFFFFW
WFFFPFFFW
WWWWWWWWW