WWWWW
WFPFW
WFCFW
WFDFW
WFFFW
WWWWW