WWWWWWWW
WWFFWWWW
WPFCFFDW
WFDWFFFW
WWWWWFFW
WWWWWCFW
WWWWFFFW
WWFFCDWW
WWFFFWWW
WWWWWWWW
