WWWWWWWW
WFFFFWWW
WFWCFWWW
WFFFFWWW
WWWWDCFW
WWWWDWFW
WWWWFPFW
WWWWWWWW
