WWWWWWWWWW
WWWFFWWWWW
WWWCFDFFFW
WWWFFCFFFW
WWWFWDCFWW
WWDFFWFDWW
WWWFFFFCWW
WWPFCFDFWW
WWWWWFFFWW
WWWWWWWWWW
